B - основоной блок программы
O - раздел описаний
P - раздел операторов
C - раздел констант
V - раздел переменных
F - раздел процедур
T - раздел типов
R1 - описание константы
R2 - описание переменных
RP - описание процедуры
P1 - оператор
OO - основной оператор
PO - производный оператор
OE - оператор присваивания
OW - оператор цикла
UO - условный оператор
V1 - переменная
C1 - константа
A - выражение
OF - оператор процедуры
N - имя
FP - фактический параметр процедуры
LA - логическое выражение
PLA - простое логическое выражение
AA - арифметическое выражение
LE - литерное выражение
SA - ссылочное выражение
SL - слагаемое
OS - операция сложения
OSR - операция сравнения
MN - множитель
OM - операция умножения
VE - вещественное число
CE - целое число
CL - константа литерного типа
CB - константа логического типа
VL - переменная литерного типа
VB - переменная логического типа
VS - переменная ссылочного типа
LS - логическое слагаемое
OT - отношение
LM - логический множитель
SO - скалярное отношение
LO - строковое отношение
IN - индекс
IV - индексированная переменная
UV - переменная с указателем
SIP - список имен переменных
ZN - знак
CHISLO - число
TYPE - тип
OTYPE - описание типа
RTYPE - регулярный тип
PTYPE - ссылочный тип
CTYPE - комбинированный тип
SPOL - список полей
SEC - секция записи
SPP - список параметров
FORMALP - совокупность формальных параметров процедуры
SFP - секция формальных параметров
PZN - параметры значения
PV - параметры переменные
SID - список идентификаторов
ID - идентификатор
CHISLO - число без знака